source_url,year,model,fair_value_usd,asking_price_usd,deal_delta_usd,deal_quality,timestamp
https://www.autotempest.com/results?localization=country&make=porsche&maxyear=2012&minyear=2009&model=cayman&transmission=auto&zip=30214,2010,,30200,24998,5202,Excellent Deal,2025-08-31T13:27:31.647208
https://www.autotempest.com/results?localization=country&make=porsche&maxyear=2012&minyear=2009&model=cayman&transmission=auto&zip=30214,2009,,32000,38887,-6887,Overpriced,2025-08-31T13:27:31.647233
https://www.autotempest.com/results?localization=country&make=porsche&maxyear=2012&minyear=2009&model=cayman&transmission=auto&zip=30214,2010,,31200,29999,1201,Excellent Deal,2025-08-31T13:27:31.647247
https://www.autotempest.com/results?localization=country&make=porsche&maxyear=2012&minyear=2009&model=cayman&transmission=auto&zip=30214,2012,,29500,42997,-13497,Overpriced,2025-08-31T13:27:31.647258
https://www.autotempest.com/results?localization=country&make=porsche&maxyear=2012&minyear=2009&model=cayman&transmission=auto&zip=30214,2009,,32200,36981,-4781,Overpriced,2025-08-31T13:27:31.647270
https://www.autotempest.com/results?localization=country&make=porsche&maxyear=2012&minyear=2009&model=cayman&transmission=auto&zip=30214,2009,,30500,31967,-1467,Overpriced,2025-08-31T13:27:31.647281
https://www.autotempest.com/results?localization=country&make=porsche&maxyear=2012&minyear=2009&model=cayman&transmission=auto&zip=30214,2009,,32000,37995,-5995,Overpriced,2025-08-31T13:27:31.647292
https://www.autotempest.com/results?localization=country&make=porsche&maxyear=2012&minyear=2009&model=cayman&transmission=auto&zip=30214,2009,,30500,32987,-2487,Overpriced,2025-08-31T13:27:31.647303
https://www.autotempest.com/results?localization=country&make=porsche&maxyear=2012&minyear=2009&model=cayman&transmission=auto&zip=30214,2011,,30500,46900,-16400,Overpriced,2025-08-31T13:27:31.647314
https://www.autotempest.com/results?localization=country&make=porsche&maxyear=2012&minyear=2009&model=cayman&transmission=auto&zip=30214,2010,,31000,30900,100,Good Deal,2025-08-31T13:27:31.647325
https://www.autotempest.com/results?localization=country&make=porsche&maxyear=2012&minyear=2009&model=cayman&transmission=auto&zip=30214,2012,,31500,38627,-7127,Overpriced,2025-08-31T13:27:31.647336
https://www.autotempest.com/results?localization=country&make=porsche&maxyear=2012&minyear=2009&model=cayman&transmission=auto&zip=30214,2010,,32700,41000,-8300,Overpriced,2025-08-31T13:27:31.647346
https://www.autotempest.com/results?localization=country&make=porsche&maxyear=2012&minyear=2009&model=cayman&transmission=auto&zip=30214,2011,,30700,43973,-13273,Overpriced,2025-08-31T13:27:31.647357
https://www.autotempest.com/results?localization=country&make=porsche&maxyear=2012&minyear=2009&model=boxster&transmission=auto&zip=30214,2011,,30000,29990,10,Good Deal,2025-08-31T13:27:31.647368
https://www.autotempest.com/results?localization=country&make=porsche&maxyear=2012&minyear=2009&model=boxster&transmission=auto&zip=30214,2012,,29000,29400,-400,Fair Price,2025-08-31T13:27:31.647379
https://www.autotempest.com/results?localization=country&make=porsche&maxyear=2012&minyear=2009&model=boxster&transmission=auto&zip=30214,2011,,30000,18885,11115,Excellent Deal,2025-08-31T13:27:31.647390
https://www.autotempest.com/results?localization=country&make=porsche&maxyear=2012&minyear=2009&model=boxster&transmission=auto&zip=30214,2009,,33200,39999,-6799,Overpriced,2025-08-31T13:27:31.647401
https://www.autotempest.com/results?localization=country&make=porsche&maxyear=2012&minyear=2009&model=boxster&transmission=auto&zip=30214,2011,,31200,31990,-790,Fair Price,2025-08-31T13:27:31.647413
https://www.autotempest.com/results?localization=country&make=porsche&maxyear=2012&minyear=2009&model=boxster&transmission=auto&zip=30214,2011,,29500,30800,-1300,Overpriced,2025-08-31T13:27:31.647424
https://www.autotempest.com/results?localization=country&make=porsche&maxyear=2012&minyear=2009&model=boxster&transmission=auto&zip=30214,2011,,31200,41998,-10798,Overpriced,2025-08-31T13:27:31.647434
https://www.autotempest.com/results?localization=country&make=porsche&maxyear=2012&minyear=2009&model=boxster&transmission=auto&zip=30214,2010,,31700,26893,4807,Excellent Deal,2025-08-31T13:27:31.647445
https://www.autotempest.com/results?localization=country&make=porsche&maxyear=2012&minyear=2009&model=boxster&transmission=auto&zip=30214,2012,,29500,19499,10001,Excellent Deal,2025-08-31T13:27:31.647456
https://www.autotempest.com/results?localization=country&make=porsche&maxyear=2012&minyear=2009&model=boxster&transmission=auto&zip=30214,2011,,29700,32999,-3299,Overpriced,2025-08-31T13:27:31.647466
https://www.autotempest.com/results?localization=country&make=porsche&maxyear=2012&minyear=2009&model=boxster&transmission=auto&zip=30214,2009,,30700,14995,15705,Excellent Deal,2025-08-31T13:27:31.647477
https://www.autotempest.com/results?localization=country&make=porsche&maxyear=2012&minyear=2009&model=boxster&transmission=auto&zip=30214,2011,,29500,23000,6500,Excellent Deal,2025-08-31T13:27:31.647488
https://www.autotempest.com/results?localization=country&make=porsche&maxyear=2012&minyear=2009&model=boxster&transmission=auto&zip=30214,2009,,31700,27990,3710,Excellent Deal,2025-08-31T13:27:31.647499
https://www.autotempest.com/results?localization=country&make=porsche&maxyear=2012&minyear=2009&model=boxster&transmission=auto&zip=30214,2010,,31700,33700,-2000,Overpriced,2025-08-31T13:27:31.647509
https://www.autotempest.com/results?localization=country&make=porsche&maxyear=2008&minyear=2005&model=boxster&transmission=auto&zip=30214,2008,,32700,29900,2800,Excellent Deal,2025-08-31T13:27:31.647520
https://www.autotempest.com/results?localization=country&make=porsche&maxyear=2008&minyear=2005&model=boxster&transmission=auto&zip=30214,2006,,35000,28995,6005,Excellent Deal,2025-08-31T13:27:31.647531
https://www.autotempest.com/results?localization=country&make=porsche&maxyear=2008&minyear=2005&model=boxster&transmission=auto&zip=30214,2006,,33300,16999,16301,Excellent Deal,2025-08-31T13:27:31.647542
https://www.autotempest.com/results?localization=country&make=porsche&maxyear=2008&minyear=2005&model=boxster&transmission=auto&zip=30214,2005,,33800,19419,14381,Excellent Deal,2025-08-31T13:27:31.647553
https://www.autotempest.com/results?localization=country&make=porsche&maxyear=2008&minyear=2005&model=boxster&transmission=auto&zip=30214,2005,,32500,15943,16557,Excellent Deal,2025-08-31T13:27:31.647564
https://www.autotempest.com/results?localization=country&make=porsche&maxyear=2008&minyear=2005&model=boxster&transmission=auto&zip=30214,2007,,33000,21988,11012,Excellent Deal,2025-08-31T13:27:31.647575
https://www.autotempest.com/results?localization=country&make=porsche&maxyear=2008&minyear=2005&model=boxster&transmission=auto&zip=30214,2005,,33500,18495,15005,Excellent Deal,2025-08-31T13:27:31.647586
https://www.autotempest.com/results?localization=country&make=porsche&maxyear=2008&minyear=2005&model=boxster&transmission=auto&zip=30214,2008,,31500,5995,25505,Excellent Deal,2025-08-31T13:27:31.647596
https://www.autotempest.com/results?localization=country&make=porsche&maxyear=2008&minyear=2005&model=boxster&transmission=auto&zip=30214,2005,,35700,28995,6705,Excellent Deal,2025-08-31T13:27:31.647607
https://www.autotempest.com/results?localization=country&make=porsche&maxyear=2008&minyear=2005&model=boxster&transmission=auto&zip=30214,2005,,32500,14995,17505,Excellent Deal,2025-08-31T13:27:31.647618
https://www.autotempest.com/results?localization=country&make=porsche&maxyear=2008&minyear=2005&model=boxster&transmission=auto&zip=30214,2005,,32700,11995,20705,Excellent Deal,2025-08-31T13:27:31.647629
https://www.autotempest.com/results?localization=country&make=porsche&maxyear=2008&minyear=2005&model=boxster&transmission=auto&zip=30214,2008,,31500,19999,11501,Excellent Deal,2025-08-31T13:27:31.647640
https://www.autotempest.com/results?localization=country&make=porsche&maxyear=2008&minyear=2005&model=boxster&transmission=auto&zip=30214,2007,,31700,29988,1712,Excellent Deal,2025-08-31T13:27:31.647651
https://www.autotempest.com/results?localization=country&make=porsche&maxyear=2008&minyear=2005&model=boxster&transmission=auto&zip=30214,2008,,31000,15900,15100,Excellent Deal,2025-08-31T13:27:31.647662
https://www.autotempest.com/results?localization=country&make=porsche&maxyear=2008&minyear=2005&model=boxster&transmission=auto&zip=30214,2006,,34700,26999,7701,Excellent Deal,2025-08-31T13:27:31.647815
https://www.autotempest.com/results?localization=country&make=porsche&maxyear=2008&minyear=2005&model=boxster&transmission=auto&zip=30214,2007,,31700,20987,10713,Excellent Deal,2025-08-31T13:27:31.647831
https://www.autotempest.com/results?localization=country&make=porsche&maxyear=2008&minyear=2005&model=boxster&transmission=auto&zip=30214,2008,,32000,22600,9400,Excellent Deal,2025-08-31T13:27:31.647843
https://www.autotempest.com/results?localization=country&make=porsche&maxyear=2008&minyear=2005&model=boxster&transmission=auto&zip=30214,2005,,32700,15958,16742,Excellent Deal,2025-08-31T13:27:31.647854
https://www.autotempest.com/results?localization=country&make=porsche&maxyear=2008&minyear=2005&model=boxster&transmission=auto&zip=30214,2008,,32900,23998,8902,Excellent Deal,2025-08-31T13:27:31.647921
https://www.autotempest.com/results?localization=country&make=porsche&maxyear=2008&minyear=2005&model=boxster&transmission=auto&zip=30214,2008,,32500,22995,9505,Excellent Deal,2025-08-31T13:27:31.647938
https://www.autotempest.com/results?localization=country&make=porsche&maxyear=2008&minyear=2005&model=boxster&transmission=auto&zip=30214,2005,,34200,16999,17201,Excellent Deal,2025-08-31T13:27:31.647951
https://www.autotempest.com/results?localization=country&make=porsche&maxyear=2008&minyear=2005&model=boxster&transmission=auto&zip=30214,2005,,33700,19986,13714,Excellent Deal,2025-08-31T13:27:31.647962
https://www.autotempest.com/results?localization=country&make=porsche&maxyear=2008&minyear=2005&model=boxster&transmission=auto&zip=30214,2006,,33700,21999,11701,Excellent Deal,2025-08-31T13:27:31.647973
https://www.autotempest.com/results?localization=country&make=porsche&maxyear=2008&minyear=2005&model=boxster&transmission=auto&zip=30214,2005,,32500,16900,15600,Excellent Deal,2025-08-31T13:27:31.647984
https://www.autotempest.com/results?localization=country&make=porsche&maxyear=2008&minyear=2005&model=boxster&transmission=auto&zip=30214,2006,,32200,16999,15201,Excellent Deal,2025-08-31T13:27:31.647995
https://www.autotempest.com/results?localization=country&make=porsche&maxyear=2008&minyear=2005&model=boxster&transmission=auto&zip=30214,2006,,33300,17988,15312,Excellent Deal,2025-08-31T13:27:31.648006
https://www.autotempest.com/results?localization=country&make=porsche&maxyear=2008&minyear=2005&model=boxster&transmission=auto&zip=30214,2005,,34200,19995,14205,Excellent Deal,2025-08-31T13:27:31.648017
https://www.autotempest.com/results?localization=country&make=porsche&maxyear=2008&minyear=2005&model=boxster&transmission=auto&zip=30214,2007,,33000,19750,13250,Excellent Deal,2025-08-31T13:27:31.648028
https://www.autotempest.com/results?localization=country&make=porsche&maxyear=2008&minyear=2005&model=boxster&transmission=auto&zip=30214,2006,,33700,21999,11701,Excellent Deal,2025-08-31T13:27:31.648039
https://www.autotempest.com/results?localization=country&make=porsche&maxyear=2008&minyear=2005&model=boxster&transmission=auto&zip=30214,2008,,32200,10999,21201,Excellent Deal,2025-08-31T13:27:31.648049
https://www.autotempest.com/results?localization=country&make=porsche&maxyear=2008&minyear=2005&model=boxster&transmission=auto&zip=30214,2006,,32000,18991,13009,Excellent Deal,2025-08-31T13:27:31.648060
https://www.autotempest.com/results?localization=country&make=porsche&maxyear=2008&minyear=2005&model=boxster&transmission=auto&zip=30214,2006,,33200,18950,14250,Excellent Deal,2025-08-31T13:27:31.648071
https://www.autotempest.com/results?localization=country&make=porsche&maxyear=2008&minyear=2005&model=boxster&transmission=auto&zip=30214,2007,,31800,18667,13133,Excellent Deal,2025-08-31T13:27:31.648082
https://www.autotempest.com/results?localization=country&make=porsche&maxyear=2008&minyear=2005&model=boxster&transmission=auto&zip=30214,2007,,34400,25500,8900,Excellent Deal,2025-08-31T13:27:31.648093
https://www.autotempest.com/results?localization=country&make=porsche&maxyear=2008&minyear=2005&model=boxster&transmission=auto&zip=30214,2007,,33500,24900,8600,Excellent Deal,2025-08-31T13:27:31.648104
https://www.autotempest.com/results?localization=country&make=porsche&maxyear=2008&minyear=2005&model=boxster&transmission=auto&zip=30214,2008,,32000,15900,16100,Excellent Deal,2025-08-31T13:27:31.648114
https://www.autotempest.com/results?localization=country&make=porsche&maxyear=2008&minyear=2005&model=boxster&transmission=auto&zip=30214,2005,,32800,16000,16800,Excellent Deal,2025-08-31T13:27:31.648125
https://www.autotempest.com/results?localization=country&make=porsche&maxyear=2008&minyear=2005&model=boxster&transmission=auto&zip=30214,2005,,32500,16900,15600,Excellent Deal,2025-08-31T13:27:31.648136
https://www.autotempest.com/results?localization=country&make=porsche&maxyear=2008&minyear=2005&model=boxster&transmission=auto&zip=30214,2006,,32200,19750,12450,Excellent Deal,2025-08-31T13:27:31.648147
https://www.autotempest.com/results?localization=country&make=porsche&maxyear=2008&minyear=2005&model=boxster&transmission=auto&zip=30214,2008,,31000,16250,14750,Excellent Deal,2025-08-31T13:27:31.648157
https://www.autotempest.com/results?localization=country&make=porsche&maxyear=2008&minyear=2005&model=boxster&transmission=auto&zip=30214,2008,,31500,17997,13503,Excellent Deal,2025-08-31T13:27:31.648168
https://www.autotempest.com/results?localization=country&make=porsche&maxyear=2008&minyear=2005&model=boxster&transmission=auto&zip=30214,2008,,32200,23995,8205,Excellent Deal,2025-08-31T13:27:31.648179
https://www.autotempest.com/results?localization=country&make=porsche&maxyear=2008&minyear=2005&model=boxster&transmission=auto&zip=30214,Unknown,,30500,,,Unknown,2025-08-31T13:27:31.648189
https://www.autotempest.com/results?localization=country&make=porsche&maxyear=2008&minyear=2005&model=boxster&transmission=auto&zip=30214,2006,,32200,16247,15953,Excellent Deal,2025-08-31T13:27:31.648200
https://www.autotempest.com/results?localization=country&make=porsche&maxyear=2008&minyear=2005&model=boxster&transmission=auto&zip=30214,2006,,33000,19980,13020,Excellent Deal,2025-08-31T13:27:31.648211
https://www.autotempest.com/results?localization=country&make=porsche&maxyear=2008&minyear=2005&model=boxster&transmission=auto&zip=30214,2008,,32500,28991,3509,Excellent Deal,2025-08-31T13:27:31.648222
https://www.autotempest.com/results?localization=country&make=porsche&maxyear=2008&minyear=2005&model=boxster&transmission=auto&zip=30214,2005,,33700,26995,6705,Excellent Deal,2025-08-31T13:27:31.648233
https://www.autotempest.com/results?localization=country&make=porsche&maxyear=2008&minyear=2005&model=boxster&transmission=auto&zip=30214,2008,,31200,16794,14406,Excellent Deal,2025-08-31T13:27:31.648244
https://www.autotempest.com/results?localization=country&make=porsche&maxyear=2008&minyear=2005&model=boxster&transmission=auto&zip=30214,2005,,34000,17995,16005,Excellent Deal,2025-08-31T13:27:31.648255
https://www.autotempest.com/results?localization=country&make=porsche&maxyear=2008&minyear=2005&model=boxster&transmission=auto&zip=30214,Unknown,,30500,,,Unknown,2025-08-31T13:27:31.648266
https://www.autotempest.com/results?localization=country&make=porsche&maxyear=2008&minyear=2005&model=cayman&transmission=auto&zip=30214,2007,,33000,,,Unknown,2025-08-31T13:27:31.648276
https://www.autotempest.com/results?localization=country&make=porsche&maxyear=2008&minyear=2005&model=cayman&transmission=auto&zip=30214,2008,,31500,17869,13631,Excellent Deal,2025-08-31T13:27:31.648287
https://www.autotempest.com/results?localization=country&make=porsche&maxyear=2008&minyear=2005&model=cayman&transmission=auto&zip=30214,Unknown,,30500,,,Unknown,2025-08-31T13:27:31.648298
https://www.autotempest.com/results?localization=country&make=porsche&maxyear=2008&minyear=2005&model=cayman&transmission=auto&zip=30214,2008,,31000,21987,9013,Excellent Deal,2025-08-31T13:27:31.648308
https://www.autotempest.com/results?localization=country&make=porsche&maxyear=2008&minyear=2005&model=cayman&transmission=auto&zip=30214,2007,,32700,24977,7723,Excellent Deal,2025-08-31T13:27:31.648319
https://www.autotempest.com/results?localization=country&make=porsche&maxyear=2008&minyear=2005&model=cayman&transmission=auto&zip=30214,2007,,32700,22995,9705,Excellent Deal,2025-08-31T13:27:31.648374
https://www.autotempest.com/results?localization=country&make=porsche&maxyear=2008&minyear=2005&model=cayman&transmission=auto&zip=30214,2006,,33000,24900,8100,Excellent Deal,2025-08-31T13:27:31.648390
https://www.autotempest.com/results?localization=country&make=porsche&maxyear=2008&minyear=2005&model=cayman&transmission=auto&zip=30214,2007,,31700,17777,13923,Excellent Deal,2025-08-31T13:27:31.648401
https://www.autotempest.com/results?localization=country&make=porsche&maxyear=2008&minyear=2005&model=cayman&transmission=auto&zip=30214,2006,,33000,26555,6445,Excellent Deal,2025-08-31T13:27:31.648412
https://www.autotempest.com/results?localization=country&make=porsche&maxyear=2008&minyear=2005&model=cayman&transmission=auto&zip=30214,2007,,31500,16950,14550,Excellent Deal,2025-08-31T13:27:31.648423
https://www.autotempest.com/results?localization=country&make=porsche&maxyear=2008&minyear=2005&model=cayman&transmission=auto&zip=30214,2007,,32000,25995,6005,Excellent Deal,2025-08-31T13:27:31.648434
https://www.autotempest.com/results?localization=country&make=porsche&maxyear=2008&minyear=2005&model=cayman&transmission=auto&zip=30214,2008,,31400,20488,10912,Excellent Deal,2025-08-31T13:27:31.648445
https://www.autotempest.com/results?localization=country&make=porsche&maxyear=2008&minyear=2005&model=cayman&transmission=auto&zip=30214,2007,,33200,32995,205,Good Deal,2025-08-31T13:27:31.648455
https://www.autotempest.com/results?localization=country&make=porsche&maxyear=2008&minyear=2005&model=cayman&transmission=auto&zip=30214,2008,,33000,34996,-1996,Overpriced,2025-08-31T13:27:31.648466
https://www.autotempest.com/results?localization=country&make=porsche&maxyear=2008&minyear=2005&model=cayman&transmission=auto&zip=30214,2006,,32200,29159,3041,Excellent Deal,2025-08-31T13:27:31.648477
https://www.autotempest.com/results?localization=country&make=porsche&maxyear=2008&minyear=2005&model=cayman&transmission=auto&zip=30214,2006,,35000,29495,5505,Excellent Deal,2025-08-31T13:27:31.648488
https://www.autotempest.com/results?localization=country&make=porsche&maxyear=2008&minyear=2005&model=cayman&transmission=auto&zip=30214,2006,,34700,50000,-15300,Overpriced,2025-08-31T13:27:31.648500
https://www.autotempest.com/results?localization=country&make=porsche&maxyear=2008&minyear=2005&model=cayman&transmission=auto&zip=30214,2008,,32000,22500,9500,Excellent Deal,2025-08-31T13:27:31.648510
https://www.autotempest.com/results?localization=country&make=porsche&maxyear=2008&minyear=2005&model=cayman&transmission=auto&zip=30214,2007,,31700,22900,8800,Excellent Deal,2025-08-31T13:27:31.648521
https://www.autotempest.com/results?localization=country&make=porsche&maxyear=2008&minyear=2005&model=cayman&transmission=auto&zip=30214,2006,,33500,26495,7005,Excellent Deal,2025-08-31T13:27:31.648532
https://www.autotempest.com/results?localization=country&make=porsche&maxyear=2008&minyear=2005&model=cayman&transmission=auto&zip=30214,2006,,32200,19888,12312,Excellent Deal,2025-08-31T13:27:31.648543
https://www.autotempest.com/results?localization=country&make=porsche&maxyear=2008&minyear=2005&model=cayman&transmission=auto&zip=30214,2006,,33200,26888,6312,Excellent Deal,2025-08-31T13:27:31.648554
https://www.autotempest.com/results?localization=country&make=porsche&maxyear=2008&minyear=2005&model=cayman&transmission=auto&zip=30214,2006,,33500,25998,7502,Excellent Deal,2025-08-31T13:27:31.648565
https://www.autotempest.com/results?localization=country&make=porsche&maxyear=2008&minyear=2005&model=cayman&transmission=auto&zip=30214,Unknown,,30500,,,Unknown,2025-08-31T13:27:31.648576
https://www.autotempest.com/results?localization=country&make=porsche&maxyear=2008&minyear=2005&model=cayman&transmission=auto&zip=30214,2008,,31000,23995,7005,Excellent Deal,2025-08-31T13:27:31.648586
https://www.autotempest.com/results?localization=country&make=porsche&maxyear=2008&minyear=2005&model=cayman&transmission=auto&zip=30214,2006,,32200,18420,13780,Excellent Deal,2025-08-31T13:27:31.648597
